#################
#################
####!       #####
###          ####
##         ######
##           ####
#################
#################