####  ################     #######
####   ###############      ######
####          ######         #####
###             ####              
##             ###                
###          ######           ####
##             #######      ######
####              ################
#####                #############
#######               ############
########                      ####
##########                        
###############             ######
######     ########           ####
######## #########################
########                          