#################
#################
####!       #####
###          ####
##                 
##           ####
## ##############
## ##############