############ ####
############ ####
####         ####
###          ####
           ######
##           ####
#################
#################