##################################
##################################
####          ######         #####
                ####           ###
                                ##
##           ##               ####
##      ########            ######
################          ########
#################            #####
################             #####
#######     ###      ###      ####
###          ##       ##      ####
###         ###             ######
##         ########              #
####   ##############      ##### #
####  ################     #####  