#################
#################
####        #####
###          ####
           ######
##           ####
############ ####
############ ####