## ##############
## ##############
##          #####
###          ####
##               
##           ####
#################
#################