####  #################    ###### 
###    ################    ###### 
##       ###########         #### 
           #########           ## 
            ######              # 
##        ########            ### 
##      ########            ##### 
###   ##########          ####### 
####  #########            ###### 
###  ######                ###### 
####                    ######### 
                     ############ 
###              ################ 
##         ###################### 
################################# 
                                  