##################################
##################################
####!         ######         #####
###             ####              
##                                
##           ######           ####
##      ##############      ######
##    ############################
##   #########   #################
##    ########   ######      #####
##          ### #####         ####
###          ## ####          ####
###         ###             ######
##         ########           ####
####   ##############      #######
####  ################     #######